 ############
### .*.*.$  ##
#   * $ * $  ##
#  $.$.*.*.$  #
# $ * *@* * $ #
#  $.*.*.$.$  #
##  $ * $ *   #
 ##  $.*.*. ###
  ###########