      #####
      #   #
####### # #
#    $ $ $#
# # ..... #
#  $.$$$.$#
### .@# . #
  #$.$$$.$##
  # .....  #
  #$ $ $   #
  # # ######
  #   #
  #####