 #### ####
##  ###  ##
#    #  . #
#   * *   #
## * $ * ##
 ## *@* ##
## * * * ##
#   * *   #
#    #    #
##  ###  ##
 #### ####