          ####
       ####  ######
       #  # .##   #
       #  $  #  # #
 #######.*.**#$## #
 #        #     # ##
## ##$##### $  $#  #
#  # . *  ####  ## #
# ##$* *$ #   #  # #
# #  .....$@$    # #
# #   ##  ######## #
# ##  ##  #        #
#  ######## ########
##          #
 ############