 #####   #####
 #   #####   #
##     *     ##
# **##$.$##** #
#  . # * # .  #
# ** #$.$# ** #
##   # . #   ##
 ### ## ## ###
  #  ## ##  #
  #    $    #
  #### @ ####
     #####