######
#    #
# ##$###
# . *  #
##  * +#
 #  $  #
 # #*###
 #   #
 ##### 