#########
# .@.$. #
# # $   #
# ##$####
#   $  ##
### .   ##
  ###    #
    ##   #
     #####