  ######
###    #
#  *##.#
# #.  .#
# $ $  #
##$#$#@#
 #    .#
 #######