 ####
 #  ###
 # *$ #
 #  # #
## ** #
#   #@#
#  ** #
#   # #
## *. #
 #  ###
 ####