   #####
  ##  @####
  #  #$$  #
###.#   # #
#  $#.#$  #
#   ...  ##
###$#.#$ #
  #     ##
  ###   #
    #####