   ####  #####
####  ####   #
# $  $     $ ####
# #   # ### #   #
#  $   $ # $$ $ #
###  ## $@$     ##
  #$ ##  # $$ $$ #
  #    $  ## ##  #
 ### #$##  ...# ##
 #  ..*.*..##.# #
 # #..*.....*.# #
 #   ########   #
 #####      #####