  ####
  #  #
  #  # #######
  #  # #..   #
  # ####..##$###
  #  $ $.*     #
  # #$ #*.# $# #
###$#  #..#  # #
#   #$ #*.# $# #
# # #  $..#  # ##
# #$#$ #..$  #  #
#   #  #..#   # #
# #@# $#*.#$# # #
#  $#  #..#   # #
##   $ $ $ ###  #
 ####   #      ##
    ############